###############
#S  #     #   #
# # # ### # # #
# # # #   # # #
# ### # ##### #
#     #       #
##### ####### #
#   #   #     #
# # ### # #####
# #   # #     #
### # ### #####
# # #     #   #
# # ##### # ###
#       #     E
###############